syntax - წერის წესები
() - ფრჩხილები, parenthesis
'' / "" - ბრჭყალები, quotation marks
variable - ცვლადი
variable name - ცვლადის სახელი
variable value - ცვლადის მნიშვნელობა
paragraph - ტექსტი
header - სათაური
memory - მეხსიერება
output - მნიშვნელობის გამოტანა
numerical value - რიცხვითი მნიშვნელობა
declare - დეკლარირება/შექმნა
execeute - გაშვება
debugging - შეცდომების გამოსწორება
store - შენახვა
frontend - საიტის ვიზუალური მხარე, რასთანაც შეხება აქვს მომხმარებელს
Backend - საიტის ფუნქციონალური მხარე, რომელსაც ჩვენ ვერ ვხედავთ
HTML - ტექნოლოგია, რომელიც გამოიყენება საიტის სტრუქტურის შესაქმნელად
CSS - ტექნოლოგია, რომელიც გამოიყენება საიტის დიზაინის შესაქმნელად
Javascript - ენა, რომლითაც ჩვენი საიტები ხდება ფუნქციონაალური,ინტერაქციული
interactivity - მოძრავი
< > - angle brackets, კუთხური ფრჩხილები
convert - გადაყვანა
anchor - ღუზა
text formatting - ტექსტის გასტილვა
bold - მუქი, გამოკვეთილი
italic - იტალიური, დახრილი
underline - ქვედახაზი
semantic - ემოციური დატვირთვის მქონე
strong - ძლიერი, მნიშვნელოვია
emphasis - ემფაზისი
connect - დაკავშირება
anchor - ღუზა
hypertext - ტექსტი რომლის მიღმაც ბმულია
link - ბმული
domain name - საიტის სახელის ის ნაწილი რომელიც ყველა მის ქვეგვერდზე იგივე რჩება
inclusive - მომცველი
accessible - ხელმისაწვდომი
format - ფორმატი, სახე
web accessibility - საიტის თავსებადობა
screen reader - ეკრანის მკითხველი
collaboration - თანამშრომლობა
compatible - თავსებადი
effective - ეფექტური
loaded - ჩატვირთული
indentation - ინდენტაცია (ცარიელი სივრცე ხაზის დასაწყისში)
best practice - საუკეთესო პრაქტიკა
matching - შესატყვისი
attach - მიმაგრება